ArchetypeSlotValidationNotImplemented=Validation of ArchetypeSlot instances is not yet implemented.
ArchetypeXLoadFailed=Could not load operational archetype '{0}' for validation.
CardinalityMustBeBounded=Cardinality interval lower must be bounded.
CardinalityOutOfBounds=The number of items ({0}) for attribute '{1}' is outside the cardinality constraint interval.
CannotResolveRmTypeName=Could not find reference model type corresponding to '{0}'.
CDefinedObjectNameChildExpected=Expected first child of name attribute to be a CDefinedObject.
ConstraintPathBadEnding=Constraint path must not end with forward slash (/): {0}.
ConstraintPathMalformed=Constraint path is malformed: {0}.
DefaultArchetypeMustBeTypeLocatable=Default archetype root must be of type Locatable.
ExpectingNodeIdXButGotY=Expecting archetypeNodeId '{0}' but got '{1}'.
ExpectingOnlyOneUnnamedChild=More than one unnamed child present. Only one unnamed child is expected.
ExpectingValueXToBeTypeY=Expecting value '{0}' to be of type {1}.
ExpressionTypeNotBoolean=Expression.Type must be 'BOOLEAN'.
IncorrectRmType=Expecting RmType '{0}' but got '{1}'.
IncorrectNodeId=Expecting Node ID '{0}' but got '{1}'.
InternalRefTargetPathFinalPartNameIncorrect=ArchetypeInternalRef target path's final path part must start with the reference model attribute name '{0}' as defined by its parent.
IsSubsetNotImplementedInX='IsSubsetOf' method of {0} is not yet implemented.
ItemXNotAllowedByAttributeY=Data item of type '{0}' is not allowed by attribute '{2}' child(ren) constraint(s).
ItemXWithIdYNotAllowedByAttributeZ=Data item of type '{0}' with node ID '{1}' is not allowed by attribute '{2}' child(ren) constraint(s).
MissingChildrenWithNodeIdX=Unable to find any cObject(s) with nodeId '{0}'.
MultiAttributeChildNotComplexObj=Expected child of multiple attribute to be assignable to CComplexObject.
NameConstraintExpected=Expected constraint object for name attribute.
NoConstraintForPathX=Unable to find a constraint to match path: {0}.
NoNodeMatchAtPath=Cannot find a legitimate matching node at the target path '{0}'.
NotAllowedByAttributeXConstraint=No match found in attribute '{0}' child(ren) constraints for data item being validated. The current data item is thus not allowed.
NotEnoughOccurrences=There are not enough occurrences of node with archetype code '{0}'. Expecting at least {1} but got {2}.
OntologyMustContainLanguageY=Archetype '{0}' ontology must contain language '{1}'.
OperatorXInvalidForTypeY={0} operator cannot be used for a {1} value.
PathYNotUniqueAtX=The following path is not unique for the path part where node ID is '{0}': {1}.
RmExpectedConstraintMissing=Attribute '{0}' expected according to the reference model but is missing.
RootConstraintInvalid=Root ArchetypeConstraint must be asssignable to CComplexObject.
SlotMustNotBeFull=Slot must not be full.
TextValueXInvalidForCodeY=DvCodedText value '{0}' does match not the term definition for the code_string '{1}'.
TmExpectedConstraintMissing=Attribute '{0}' expected according to archetype/template constraint but is missing.
TmForbiddenConstraint=Attribute '{0}' is forbidden but exists.
TooManyOccurrences=There are too many occurrences of node with archetype code '{0}'. Expecting at most {1} but got {2}.
TypeXNotSupportedByYOperator=Type '{0}' is not supported for {1} operator.
UnexpectedAttributeX=Unexpected attribute '{0}' is present.
UnsupportedExpressionOperator=Expression operator '{0}' is not supported.
UnsupportedExprLeafReferenceType=ExprLeaf.ReferenceType '{0}' is not supported.
ValueMustImplementIRmType=Value being validated must implement IRmType, but is of type {0} which does not.
XIsNotTypeYValue='{0}' is not a {1} value.
XMustBeValidY={0} must be a valid {1}.
XMustImplementY=Value of type {0} is expected to implement {1} but does not.
YNotAllowedByAttributeXConstraint=No match found in attribute '{0}' child(ren) constraints for data item being validated ({1}). The current data item is thus not allowed.
DateXDoesNotMatchPatternY=Date value '{0}' does not match pattern '{1}'.
DateTimeXDoesNotMatchPatternY=Datetime value '{0}' does not match pattern '{1}'.
DurationXDoesNotMatchPatternY=Duration value '{0}' does not match pattern '{1}'.
TimeXDoesNotMatchPatternY=Time value '{0}' does not match pattern '{1}'.
InvalidIsoDateX='{0}' is an invalid ISO8601 date.
InvalidIsoDateTimeX='{0}' is an invalid ISO8601 datetime.
InvalidIsoDurationX='{0}' is an invalid ISO8601 duration.
InvalidIsoTime='{0}' is an invalid ISO8601 time.
InvalidIntegerX=Invalid integer value ({0}).
InvalidRealX=Invalid real value ({0}).
InvalidStringX=Invalid string value '{0}'.
InvalidDvStateX='{0}' is an invalid DvState.
InvalidDvOrdinalX='{0}' is an invalid DvOrdinal.
InvalidDvQuantityX='{0}' is an invalid DvQuantity.
DateXOutOfRange=Date value '{0}' is out of range.
DateTimeXOutOfRange=Datetime value '{0}' is out of range.
DurationXOutOfRange=Duration value '{0}' is out of range.
IntegerXOutOfRange=Integer value ({0}) is out of range.
RealXOutOfRange=Real value ({0}) is out of range.
TimeXOutOfRange=Time value '{0}' is out of range.
XNotInCDvOrdinalList=Ordinal value ({0}) is not in CDvOrdinal.List.
XNotInCIntegerList=Integer value ({0}) is not in CInteger.List.
XNotInCRealList=Real value ({0}) is not in CReal.List.
XNotInCStringList=String  value ({0}) is not in CString.List.
CRealAssumedValueSetFalse=CReal.AssumedValueSet must be true.
ConstraintXIsValidGetsFalse={0}.IsValid() must be true.
StringXDoesNotMatchPatternY=String value '{0}' does not match pattern '{1}'.
StandardEquivNotImplementedInX='StandardEquivalent' method of {0} is not yet implemented.
DefaultValueNotImplementedInX='DefaultValue' property of {0} is not yet implemented.
DvOrdinalSymbolXIncorrectForCodeY=DvOrdinal symbol value '{0}' does not match  the term definition for the symbol code ({1})
CodePhraseTerminologyWrong=Expecting terminology ID '{0}' but got '{1}'.
CodeStringXNotInList=Unexpected code string '{0}'. Not in codes list.

OntologyMissingDefinitionTerm=Archetype ontology does not have term for archetype definition.
ArchetypeVersionNotEqual=Archetype.Version() must be equal to Archetype.ArchetypeId.VersionId
ArchetypeSpecialisationInvariantFail=If archetype is specialised the specialisation depth must be greater than zero.
ExistenceOutOfRange=Existence.Lower must be >=0 and Existence.Upper must <=1.
MultiAttributeMembersBad=CMultipleAttributes.Members() is not null so each member's Occurences.Upper must be <=1.
CardinalityLowerUnbounded=Cardinality must be lower bounded.
SingleParentOccurrencesBad=CObject.Parent is not null and is CSingleAttribute so its Occurrences.Upper must be <=1.
AssumedValueInvalid=Assumed value present but that value is not valid against the constraint.
CComplexObjectAllowAnyXor=Either CComplexObject.Attributes is not null and not empty or CComplexObject must allow any attribute.
CPrimitiveObjectAllowAnyXor=Either CPrimitiveObject.Item is not null or CPrimitiveObject must allow any item.
ArchetypeInternalRefTargetPathMissing=If ArchetypeInternalRef.TargetPath is not null/empty then the root object must have the target path (ultimate_root.HasPath(Targetpath) must be true).