AssertionExpressMustBeBool=Assertion expression type must be 'BOOLEAN' where expression is not null.
CDurationPatternAndRangeNull=If CDuration.Range is null, pattern must not be null.
CIntegerListAndRangeNotNull=If CIngeger.List or CInteger.Range is not null, the other must be null.
CIntegerListXorRange=Either CInteger.List of CInteger.Range must be not null.
CRealListAndRangeNotNull=If CReal.List or CReal.Range is not null, the other must be null.
CRealListXorRange=Either CReal.List of CReal.Range must be not null.
CStringListAndPatternNotNull=If CString.List or CString.Pattern is not null, the other must be null.
CStringListXorPattern=Either CString.List or CString.Pattern must be not null.
DatePatternInvalid=Date pattern is invalid: {0}.
DefaultsSerialisationNotImplemented=Serialisation of default values not implemented.
DurationPatternInvalid=Duration pattern is invalid: {0}.
EitherTrueOrFalseMustBeValid=Either trueValid or falseValid must be set to true.
ExpectedLocalNameIsXNotY=Expected local name is '{0}', not '{1}'.
IfXIsNotNullMustBeEmpty=If {0} is not null it must not be empty.
InvalidDayValidityX='{0}' is an invalid DayValidity.
InvalidHourValidityX='{0}' is an invalid HourValidity.
InvalidMinuteValidityX='{0}' is an invalid MinuteValidity.
InvalidMonthValidityX='{0}' is an invalid MonthValidity.
InvalidSecondValidityX='{0}' is an invalid SecondValidity.
LoopingMethodTerminated=The method '{0}' with parameter type '{1}' is looping and is terminated.
MethodXNotImplementedForParamTypeY=The method '{0}' with parameter type '{1}' is not implemented.
OntologyMissingCode=Archetype ontology does not contain specified term/constraint code ({0}).
OntologyMissingLanguageX=Archetype ontology does not contain specified language ({0}).
OntologyMissingTerminologyX=Archetype ontology does not contain specified terminology ({0}).
OpenEhrTypeMissingAmTypeAttribute=openEHR type {0} does not have an AmTypeAttribute.
PatternMustBeNullBeforeSet=Date pattern must be null before being set.
RegexGroupsMustNotBeNull=Regular expression match groups must not be null.
SpecialisationDepthLessThanZero=Specialisation depth value must be >=0.
TimePatternInvalid=Time pattern is invalid: {0}.
XIsNull={0} is null.
XIsNullOrEmpty={0} is null or empty.
XMustNotBeNull={0} must not be null.
XMustNotBeNullOrEmpty={0} must not be null or empty.
CBooleanInvariant=At least one of CBoolean.TrueValid and CBoolean.FalseValid must be true.
CBooleanDefaultInvalid=CBoolean.DefaultValue invalid against the CBoolean restrictions.